0000000000000000000000000000000000000000
0000000000000000000000000000000000000000
0000000000000000000000000000000000000000
0000000000000000000000000000000000000000
0000000000000000000000000000000000000000
0000000000000000000000000000000000000000
0000000000000000000000000000000000000000
0000000000000000000000000000000000000000
0000000000000000000000000000000000000000
0000000000000000000000000000000000000000
0000000000000000000000000000000000000000
0000000000000000000000000000000000000000
0000000000000000000000000000000000000000
0000000000000000000000000000000000000000
0000000000000000000000000000000000000000
0000001000000000000000000000000001000000
0000000000000000000000000000000000000000
0000000000000000002220000000000000000000
0000022222000000002220000000002222200000
0000000000000000002220000000000000000000
0000000000000000000000000000000000000000
0000000000000000000000000000000000000000
0000000000000000000000000000000000000000
0000000000000000000000000000000000000000
0000000000000000000000000000000000000000
0000000000000000000000000000000000000000
0000000000000000000000000000000000000000
0000000000000000000000000000000000000000
0000000000000000000000000000000000000000
0000000000000000000000000000000000000000
-
0000000000000000000000000000000000000000
0000000000000000000100000000000000000000
0000000000000000000000000000000000000000
0000000000000000000000000000000000000000
0000000000000000002220000000000000000000
0000000000000000000200000000000000000000
0000002000000000000200000000000002000000
0000002000000000000200000000000002000000
0000002000000000000200000000000002000000
0000002000000000000200000000000002000000
0000002000000000000000000000000002000000
0000002000000000000000000000000002000000
0000002000000000000000000000000002000000
0000102000000000000000000000000002000000
0000002000000000000000000000000002000000
0000002000000000000000000000000002000000
0002222000000000000000000000000002000000
0000002000000000000000000000000002000000
0000002000000000000000000000000002000000
0000002000000000000000000000000002000000
0000000000000000000200000000000002010000
0000000000000000000200000000000002000000
0000000000000000000201000000000002000000
0000000000000000000200000000000002220000
0000000000000000000200000000000000000000
0000000000000000000222000000000000000000
0000000000000000000000000000000000000000
0000000000000000000000000000000000000000
0000000000000000000000000000000000000000
0000000000000000000000000000000000000000
-
0000000000000000000000000000000000000000
0000000000000000000000000000000000000000
0000000000000000000000000000000000000000
0000000000000000000000000000000000000000
0000000000000000000000000000000000000000
0000000000000000000000000000000000000000
0000000000000000000000000000000000000000
0000000000000000000000000000000000000000
0000000000000000000000000000000000000000
0000000000000000000000000000000000000000
0000000000000000000000000000000000000000
0000000000000000000000010000000000000000
0000000000000000000000000000000000000000
0000000000000000000000000000000000000000
0000000000000000000000000000000000000000
0000001000000000000000000000000001000000
0000000000000001000000020000000000000000
0000000000000000000000020000000000000000
0000002000000000000000000000000000000000
0000002000000002000000000000000002000000
0000000000000002000000000000000002000000
0000000000000002000000000000000000000000
0000000000000000000000000000000000000000
0000000000000000000000000000000000000000
0000000000000000000000000000000000000000
0000000000000000000000000000000000000000
0000000000000000000000000000000000000000
0000000000000000000000000000000000000000
0000000000000000000000000000000000000000
0000000000000000000000000000000000000000
-
0000000000000000000000000000000000000000
0000000000000000000000000000000000000000
0000000000000000000000000000000000000000
0222222222222222222222222222222222222220
0200000000000000000000000000000000000020
0200000000000000000000000000000000000020
0200000000000000000000000000100000000020
0200000000000000000000000000000000000020
0200000000000000000000000000000000000020
0200000000000000000000000000000000000020
0200000000022222222222222222000000000020
0200000000000000000000000000000000000020
0200000000001000000000000000000000000020
0200000000000000000000000000000000000020
0200222022002022220200202222000000000020
0200202020202020000200202200000000000020
0200222020202020020200200022000000000020
0200202020022022220222202222000000000020
0200000000000000000000000000000000000020
0200000000000000000000000000000000000020
0200000000000000000000000000000000000020
0200000000000000000000000000000022222220
0200000000000000000000000000000020000000
0222222200000000000000000000000020000000
0000000200000000000000000000000020000000
0000000200000000000000000000000020000000
0000000222222222222222222222222220000000
0000000000000000000000000000000000000000
0000000000000000000000000000000000000000
0000000000000000000000000000000000000000
